WE ./pics/bluestone.xpm
EA ./pics/colorstone.xpm
SO ./pics/redbrick.xpm
NO ./pics/wood.xpm
C 255,200,160
F 122,122,122
P   "sprites/wizard0.xpm"

                                         11111
                                        11000111111111
11111111111111111                       11000000000001
100000000000000011111111111111111111111111000000P00001
100000000000000000000000000000000000000000000000000001
10000P000000000011111111111111111111111111111111111111
10000000000000001
10000000000000001
10000000000000001
10000000000000001
10000000000000001
10000000000000001
10000000000000001
10000000000000001
11111011111111111
    101
11111011111111111
10000000000000001
10000000000000001
10000000000000001
10000000000000001
10000000000000001
10000000000000001
10000000000000001
10000000000000001
10000000000000001
10000000000000001
10000P000000000E1
11111111111111111