
NO ./path
SO ./path
WE ./path
EA ./path
F 220,100,0
C 225,30,0

   111111111111111111
   100000000000000001
   100001000000000001
11110000000000000000111111
1000000000001111000000001
10000000W0000000000000011
10000000001100000000000001
1111111111111111111111111