WE ./path

EA ./path
C            255,255,255            
F  255,255,255
NO ./path           
SO        ./path


      1111
   111110111111111111
   10001011 100000001
   100011111100000001
11110000000000000000111111
  10000000001111000000001
1110000000000010000000011
1000000000110000000E000001
1111111111111111111111111
