
NO ./path
SO ./path
WE ./path
EA ./path
F 220,100,0
C 225,30,0

   11111 111111111111
   10001 11 100000001
   100011111100000001
11110000000000000000111111
  10000000001111000000001
11100000W0000010000000011
10000000001100000000000001
1111111111111111111111111