WE ./path

EA ./path
C             225,30,0
F  220,100,0
NO ./path           
SO        ./path


      1111
   111110111111111111
   10001011 100000001
   100011111100000001
11110000000000000000111111
  10000000001111000000001
11100000W0000010000000011
10000000001100000000000001
1111111111111111111111111
