WE ./path

EA ./path
C             225,30,0
F  220,100,0
NO ./path           
SO        ./path

11111
10001
1E001
10001
11111
